................................................................................................................................................................................................................................................................
................................................................................................................................................................................................................................................................
................................................................................................................................................................................................................................................................
................................................................................................................................................................................................................................................................
................................................................................................................................=============================================================...................................................................
....................................................................................................................=========================================================================...................................................................
......@..............^^............................^^............=======================================================================================================================================================================================
========================================================================================================================================================================================================================================================================