............................................................................................................................................................................................................................................................======
................................................................................................................................................................................................................................................................==
................................................................................................................................................................................................................................................................==
................................................................................................................................................................................................................................................................==
................................................................................................................................=============================================================...................................................................==
....................................................................................................................=========================================================================...................................................................==
......@..............^^.......^^........^^...................=====================================================================================================================================================================================================
========================================================================================================================================================================================================================================================================