...................=.....=......====...=.......=...====...=..................................................................................................................................................................................................................................................................................................
..................==.....=......=.......=.....=....=......=..................................................................................................................................................................................................................................................................................................
.................=.=.....=......==.......=...=.....==.....=..................................................................................................................................................................................................................................................................................................
...................=.....=......=.........=.=......=......=..................................................................................................................................................................................................................................................................................................
...................=.....====...====.......=.......====...====...............................................................................................................................................................................................................................................................................................
.............................................................................................................................................................................................................................................................................................................................................................
.............................................................................................................................................................................................................................................................................................................................................................
........................................................f....................................................................................................................................................................................................................................................................................................
.............................................................................................................................................................................................................................................................................................................................................................
......@.....^^.......^^.......^^........^^......$............................................................................................................................................................................................................................................................................................................
=============================================================================================================================================================================================================================================================================================================================================================