.................==.....=......====...=.......=...====...=...................................................................................................................................................................................................................................................................................................
................=..=....=......=.......=.....=....=......=...................................................................................................................................................................................................................................................................................................
..................=.....=......==.......=...=.....==.....=...................................................................................................................................................................................................................................................................................................
.................=......=......=.........=.=......=......=...................................................................................................................................................................................................................................................................................................
................====....====...====.......=.......====...====................................................................................................................................................................................................................................................................................................
.............................................................................................................................................................................................................................................................................................................................................................
.............................................................................................................................................................................................................................................................................................................................................................
.........................................................................................................................................................................................................................................................................................................................................................f...
.............................................................................................................................................................................................................................................................................................................................................................
......@.....^^.......^^.......^^........^^......$............................................................................................................................................................................................................................................................................................................
=============================================================================================================================================================================================================================================================================================================================================================