.................==.....=......====...=.......=...====...=...................................................................................................................................................................................................................................................................................................
................=..=....=......=.......=.....=....=......=...................................................................................................................................................................................................................................................................................................
..................=.....=......==.......=...=.....==.....=...................................................................................................................................................................................................................................................................................................
................=..=....=......=.........=.=......=......=...................................................................................................................................................................................................................................................................................................
.................==.....====...====.......=.......====...====................................................................................................................................................................................................................................................................................................
.............................................................................................................................................................................................................................................................................................................................................................
.............................................................................................................................................................................................................................................................................................................................................................
........................................................................................................................................................................................................................................................................................................................................................f....
.............................................................................................................................................................................................................................................................................................................................................................
.............................................................................................................................................................................................................................................................................................................................................................
......@.....^^.......^^.......^^........^^......$............................................................................................................................................................................................................................................................................................................
=============================================================================================================================================================================================================================================================================================================================================================